S R R R T T R R
R B R T R B R R
R R R R B R T R
T T R R R R R G
R R R B T B R R
B R R R R R R P